{
  "grid": [
    ["B", "B", "B", "B", "B", "B", "B", "B", "B", "B", "B", "B", "B", "B", "B", "B", "B", "B", "B", "B", "B", "B", "B", "B", "B", "B", "B", "B"],
    ["B", "F", "F", "F", "F", "F", "F", "F", "F", "F", "F", "F", "F", "S", "S", "F", "F", "F", "F", "F", "F", "F", "F", "F", "F", "F", "F", "B"],
    ["B", "F", "S", "S", "S", "S", "F", "S", "S", "S", "S", "S", "F", "S", "S", "F", "S", "S", "S", "S", "S", "F", "S", "S", "S", "S", "F", "B"],
    ["B", "U", "S", "S", "S", "S", "F", "S", "S", "S", "S", "S", "F", "S", "S", "F", "S", "S", "S", "S", "S", "F", "S", "S", "S", "S", "U", "B"],
    ["B", "F", "S", "S", "S", "S", "F", "S", "S", "S", "S", "S", "F", "S", "S", "F", "S", "S", "S", "S", "S", "F", "S", "S", "S", "S", "F", "B"],
    ["B", "F", "F", "F", "F", "F", "F", "F", "F", "F", "F", "F", "F", "F", "F", "F", "F", "F", "F", "F", "F", "F", "F", "F", "F", "F", "F", "B"],
    ["B", "F", "S", "S", "S", "S", "F", "S", "S", "F", "S", "S", "S", "S", "S", "S", "S", "S", "F", "S", "S", "F", "S", "S", "S", "S", "F", "B"],
    ["B", "F", "S", "S", "S", "S", "F", "S", "S", "F", "S", "S", "S", "S", "S", "S", "S", "S", "F", "S", "S", "F", "S", "S", "S", "S", "F", "B"],
    ["B", "F", "F", "F", "F", "F", "F", "S", "S", "F", "F", "F", "F", "S", "S", "F", "F", "F", "F", "S", "S", "F", "F", "F", "F", "F", "F", "B"],
    ["B", "B", "B", "B", "B", "B", "F", "S", "S", "S", "S", "S", " ", "S", "S", " ", "S", "S", "S", "S", "S", "F", "B", "B", "B", "B", "B", "B"],
    ["B", "B", "B", "B", "B", "B", "F", "S", "S", "S", "S", "S", " ", "S", "S", " ", "S", "S", "S", "S", "S", "F", "B", "B", "B", "B", "B", "B"],
    ["B", "B", "B", "B", "B", "B", "F", "S", "S", " ", " ", " ", " ", " ", " ", " ", " ", " ", " ", "S", "S", "F", "B", "B", "B", "B", "B", "B"],
    ["B", "B", "B", "B", "B", "B", "F", "S", "S", " ", "I", "I", "I", "D", "D", "I", "I", "I", " ", "S", "S", "F", "B", "B", "B", "B", "B", "B"],
    ["B", "B", "B", "B", "B", "B", "F", "S", "S", " ", "I", "I", "I", "I", "I", "I", "I", "I", " ", "S", "S", "F", "B", "B", "B", "B", "B", "B"],
    [" ", " ", " ", " ", " ", " ", "F", " ", " ", " ", "I", "I", "I", "I", "I", "I", "I", "I", " ", " ", " ", "F", " ", " ", " ", " ", " ", " "],
    ["B", "B", "B", "B", "B", "B", "F", "S", "S", " ", "I", "I", "I", "I", "I", "I", "I", "I", " ", "S", "S", "F", "B", "B", "B", "B", "B", "B"],
    ["B", "B", "B", "B", "B", "B", "F", "S", "S", " ", "I", "I", "I", "I", "I", "I", "I", "I", " ", "S", "S", "F", "B", "B", "B", "B", "B", "B"],
    ["B", "B", "B", "B", "B", "B", "F", "S", "S", " ", " ", " ", " ", " ", " ", " ", " ", " ", " ", "S", "S", "F", "B", "B", "B", "B", "B", "B"],
    ["B", "B", "B", "B", "B", "B", "F", "S", "S", " ", "S", "S", "S", "S", "S", "S", "S", "S", " ", "S", "S", "F", "B", "B", "B", "B", "B", "B"],
    ["B", "B", "B", "B", "B", "B", "F", "S", "S", " ", "S", "S", "S", "S", "S", "S", "S", "S", " ", "S", "S", "F", "B", "B", "B", "B", "B", "B"],
    ["B", "F", "F", "F", "F", "F", "F", "F", "F", "F", "F", "F", "F", "S", "S", "F", "F", "F", "F", "F", "F", "F", "F", "F", "F", "F", "F", "B"],
    ["B", "F", "S", "S", "S", "S", "F", "S", "S", "S", "S", "S", "F", "S", "S", "F", "S", "S", "S", "S", "S", "F", "S", "S", "S", "S", "F", "B"],
    ["B", "F", "S", "S", "S", "S", "F", "S", "S", "S", "S", "S", "F", "S", "S", "F", "S", "S", "S", "S", "S", "F", "S", "S", "S", "S", "F", "B"],
    ["B", "U", "F", "F", "S", "S", "F", "F", "F", "F", "F", "F", "F", "p", "m", "F", "F", "F", "F", "F", "F", "F", "S", "S", "F", "F", "U", "B"],
    ["B", "S", "S", "F", "S", "S", "F", "S", "S", "F", "S", "S", "S", "S", "S", "S", "S", "S", "F", "S", "S", "F", "S", "S", "F", "S", "S", "B"],
    ["B", "S", "S", "F", "S", "S", "F", "S", "S", "F", "S", "S", "S", "S", "S", "S", "S", "S", "F", "S", "S", "F", "S", "S", "F", "S", "S", "B"],
    ["B", "F", "F", "F", "F", "F", "F", "S", "S", "F", "F", "F", "F", "S", "S", "F", "F", "F", "F", "S", "S", "F", "F", "F", "F", "F", "F", "B"],
    ["B", "F", "S", "S", "S", "S", "S", "S", "S", "S", "S", "S", "F", "S", "S", "F", "S", "S", "S", "S", "S", "S", "S", "S", "S", "S", "F", "B"],
    ["B", "F", "S", "S", "S", "S", "S", "S", "S", "S", "S", "S", "F", "S", "S", "F", "S", "S", "S", "S", "S", "S", "S", "S", "S", "S", "F", "B"],
    ["B", "F", "F", "F", "F", "F", "F", "F", "F", "F", "F", "F", "F", "F", "F", "F", "F", "F", "F", "F", "F", "F", "F", "F", "F", "F", "F", "B"],
    ["B", "B", "B", "B", "B", "B", "B", "B", "B", "B", "B", "B", "B", "B", "B", "B", "B", "B", "B", "B", "B", "B", "B", "B", "B", "B", "B", "B"]
  ]
}
